NotInput=请输入[0]!

RequireObject=请选择至少一个对象!
RequireRelationship=请选择至少一个关系!
RequireTwoObjects=请选择两个对象!
RequireOnlyOneObject=请选择一个对象!
RequireOnlyOneRelationship=请选择一个关系!
TwoManyRowsSelected=选择的对象太多，不能超过[0]个！

RelationDirectionNotSelected=请选择关系的方向！
RelationTypeNotSelected=请选择关系类型！

SelectedItemInvalid=选择的数据不正确！
WindowNotFound=窗口未找到！
FileNotSelected=请选择文件！
RemoteCallFailed=调用失败，请检查网络连接！

#status messages
WelcomeMessage=欢迎使用本系统！
Ready=就绪
Finding=正在检索中...
OpeningSet=正在打开收藏夹“{0}”...
OpeningQuery=正在打开查询“{0}”...
ObjectTotalNoAndSelectedNo=就绪（共有[0]个对象，选中了[1]个对象）
ReadyStatusMsg=就绪（共有{0}个对象，选中{1}个对象，另有{2}个对象被隐藏）
CreateObjectSuccess=创建对象成功！
CreateObjectFailed=创建对象失败！\n[0]
ConnectSuccess=创建关系成功！
ConnectFailed=创建关系失败！\n[0]
OperationSuccess=操作成功！
OperationFailed=操作失败！\n[0]
SearchSuccess=检索成功！
SearchFailed=检索失败！\n[0]

GetVaultListSuccess=取得仓库成功！
GetVaultListFailed=取得仓库失败！\n[0]
GetTypePolicyListSuccess=取得策略列表成功！
GetTypePolicyListFailed=取得策略列表失败！\n[0]
GetSysTypeAttributesSuccess=取得属性列表成功！
GetSysTypeAttributesFailed=取得属性列表失败！\n[0]
GetFirstRevisionSuccess=取得第一个版本号成功！
GetFirstRevisionFailed=取得第一个版本号失败！\n[0]

GetObjectAttrSuccess=取得对象属性成功！
GetObjectAttrFailed=取得对象属性失败！\n[0]
GetObjectBasicSuccess=取得对象基本信息成功！
GetObjectBasicFailed=取得对象基本信息失败！\n[0]
CloneObjectSuccess=克隆对象成功！
CloneObjectFailed=克隆对象失败！\n[0]
ReviseObjectSuccess=版本升级成功！
ReviseObjectFailed=版本升级失败！\n[0]

GetConnectInfoSuccess=取得关联信息成功！
GetConnectInfoFailed=取得关联信息失败！\n[0]
GetSysRelationAttributesSuccess=取得属性列表成功！
GetSysRelationAttributesFailed=取得属性列表失败！\n[0]
DeleteObjectSuccess=删除对象成功！
DeleteObjectFailed=删除对象失败！\n[0]
LockObjectSuccess=锁定对象成功！
LockObjectFailed=锁定对象失败！\n[0]
UnlockObjectSuccess=解除锁定成功！
UnlockObjectFailed=解除锁定失败！\n[0]

ModifyObjectSuccess=修改属性成功！
ModifyObjectFailed=修改属性失败！\n[0]
DemoteObjectSuccess=生命周期降级成功！
DemoteObjectFailed=生命周期降级失败！\n[0]
PromoteObjectSuccess=生命周期升级成功！
PromoteObjectFailed=生命周期升级失败！\n[0]

GetObjectFilesSuccess=取得文件列表成功！
GetObjectFilesFailed=取得文件列表失败！\n[0]
GrantAccessSuccess=对象授权成功！
GrantAccessFailed=对象授权失败！\n[0]
RevokeAccessSuccess=解除权限成功！
RevokeAccessFailed=解除权限失败！\n[0]

GetObjectVersionsSuccess=取得对象版本列表成功！
GetObjectVersionsFailed=取得对象版本列表失败！\n[0]
GetCommandSuccess=取得命令参数成功！
GetCommandFailed=取得命令参数失败！\n[0]
CheckinFileSuccess=文件检入成功！
CheckinFileFailed=文件检入失败！\n[0]
DeleteObjectFileSuccess=删除文件成功！
DeleteObjectFileFailed=删除文件失败！\n[0]

GetTypeTreeSuccess=取得类型成功！
GetTypeTreeFailed=取得类型失败！\n[0]
GetUserTreeSuccess=取得用户成功！
GetUserTreeFailed=取得用户失败！\n[0]


GetRelationBasicSuccess=取得关系信息成功！
GetRelationBasicFailed=取得关系信息失败！\n[0]
GetRelationAttrSuccess=取得关系属性成功！
GetRelationAttrFailed=取得关系属性失败！\n[0]

DeleteRelationSuccess=解除关系成功！
DeleteRelationFailed=解除关系失败！\n[0]
FreezeRelationSuccess=冻结关系成功！
FreezeRelationFailed=冻结关系失败！\n[0]
ThawRelationSuccess=关系解冻成功！
ThawRelationFailed=关系解冻失败！\n[0]

ModifyRelationSuccess=修改关系属性成功！
ModifyRelationFailed=修改关系属性失败！\n[0]

IndentedTableSortSuccess=缩进表格排序成功！
IndentedTableSortFailed=缩进表格排序失败！\n[0]
ShrinkIndentedTableSuccess=收缩节点成功！
ShrinkIndentedTableFailed=收缩节点失败！\n[0]
ExpandIndentedTableSuccess=展开节点成功！
ExpandIndentedTableFailed=展开节点失败！\n[0]
LoadIndentedTableSuccess=载入缩进表格成功！
LoadIndentedTableFailed=载入缩进表格失败！\n[0]

GetSubDirsSuccess=取得子目录成功！
GetSubDirsFailed=取得子目录失败！\n[0]
GetDirObjsSuccess=取得目录下的对象成功！
GetDirObjsFailed=取得目录下的对象失败！\n[0]
CreateSubDirSuccess=创建目录成功！
CreateSubDirFailed=创建目录失败！\n[0]

GetToolBarSuccess=取得工具条成功！
GetToolBarFailed=取得工具条失败！\n[0]

DirNotSelected=请选择目录！

ParamOrSettingsInvalid=参数或配置错误！
ExpandAllBothDirection=不能同时在From和To两个方向进行全展开！

MeetingRoomNameExists=同名的会议室已存在！
UserAlreadyLogin=该用户名已经登录！
MaxConnectReached=已经到最大连接数！
ProductLineNotSelected=产品线未选择！
SaveSuccess=保存成功！
DeleteSuccess=删除成功！

DelDirSuccess=删除成功，请刷新！

WFNoName=工作流名称未输入！
WFMoreThanOneStartNode=开始节点不能多于一个！
WFNoStartNode=没有开始节点！
WFNoEndNode=没有结束节点！
WFNoNodeName=节点名未输入！
WFNoLinkName=连接名未输入！
WFTooManyInLinks= 输入连接过多！
WFTooManyOutLinks= 输出连接过多！
WFNoInLinks= 输入连接过少！
WFNoOutLinks= 输出连接过少！
WFValidateOk=工作流验证成功！